XXXXXXXXXXXXXXXXXXX
X-----------------X
X-----------------X
X-OO----------OOOOX
XLLLL---------LLLLX
X-----------M-----X
X-OO------------O-X
XLLLL-M-------LLLLX
X-----------------X
X----------M----O-X
X-----------O-XXXXX
X---P-------XXXXXXX
XXXXXXXXXXXXXXXXXXX
XXXXXXXXXXXXXXXXXXX