XXXXXXXXXXXXXXXXXXX
X-----------------X
X-----------------X
XOOO--------------X
XLLLL-------------X
X----------M---OOOX
X-------------LLLLX
XOOO---M----------X
XLLLL-------------X
X----------M--OOOOX
X------------OXXXXX
X---P-------OXXXXXX
XXXXXXXXXXXXXXXXXXX
XXXXXXXXXXXXXXXXXXX