XXXXXXXXXXXXXXXXXXX
X----------------OX
X---O------O-XXXXXX
X--XXXXXXXXXX-----X
X-X---------------X
XX--O----O--------X
XXXXXXXXXXXX------X
X-----------X-----X
X------------X--O-X
X-------------XXXXX
X---P------OXXXXXXX
X---------XXXXXXXXX
XXXXXXXXXXXXXXXXXX